p----------q
|          |
|          |
|          |
|  s       |
|          |
|          |
|          |
|          |
|          |
|          |
b----------d
